111111
100001
100001
100001
100001
112111